111111111111111111111111111111111111111111111111
111001100001111100110000101110100001000011010101
110101101101111010110111101110101111011011010101
101101111011110110110001110101100011000011010101
100000110111110000010111110101101111010111111111
111101100001111110110000111011100001011011010101
111111111111111111111111111111111111111111111111
1PCCCCCCCCCCCCCCCCCCCCCCCCCCCCCCCCCCCCCCCCCCCCE1
111111111111111111111111111111111111111111111111