11111111111111111
1C10C10C010000C11
10000101100010001
10100001111111101
1P100C0000C0000E1
11111111111111111