1111111111111111
1001001001001001
1001111111111001
1000000CC0000001
100000C00C000001
10000C0110C00001
1000C001100C0001
100C00111100C001
10P0000000000E01
1000001111000001
1111111111111111