1111111111111111111111111111111
1001001001001000C00000000000001
1111111111111001110000000000001
1000000CC0000001110000000000001
100000C00C000000C00000000000001
10000C0110C0000C000000000000001
1000C001100C000000C000000000001
100C00111100C000000C00000000001
10P00000000011100000C0000011111
100000111100101000000C000110001
1111111111111111111110C01100101
1000000000000000010000001000001
10E0C0000000C0010C0100001000001
10000000C0000C0011100C001100101
1111111C000000C00100C0000110001
100100100000C00C000C00000011111
11111110C00C000000C000000000001
1001001000000000000000000000001
1111111111111111111111111111111