1111111111
1001001001
1111111111
1PCCCCCCC1
1CCCCCCCC1
1CCCCCCCE1
1111111111