11111111111111111111
1P0000000C0000000E11
11111111111111111111