1111111111
101P00C101
1011001101
1000000001
1011111101
1010000101
1010C10101
1010E10101
1010110101
1010000101
1011C11101
1000010001
1000000001
1111111111