1111111
10000C1
1P10011
10000E1
1111111
