1111111111
10000C0001
101C000001
100000C001
1011100011
1000000001
1110110E11
1P00000C01
1100010001
1111111111
