11111111111111111111111111111111111111111111111111
11111111100000000000000000000000000000000011111111
11111111100000000000000000000000000000111001111111
10000000000000000000000000111111111001111100111111
1000C000011100000000000000111111100011111110111111
100CCC0011011000000000000011111110C011111100011111
1000C00001110000000000000011111100001111110C011111
10000000000000000000000000111100001111111100011111
11111111111111111111111000000001111111111110111111
11111111111111111111100000C01111111111111110111111
11111111111111100000001110000000111111111100011111
11111111111111101111100000011110011111111100011111
11111111111110000111111001111110000111111110111111
11111111111110CC00111000000111100C0000000000111111
11111111111110000000111001111111000111111111111111
11111111111111110000000000000000000000000000001111
11111111111111111100000000000000000000000000011111
11111111111111111101111111111000111111111111111111
111111111111111111011111111110P0111111111111111111
11111111111111111000111111111000111111111111111111
111111111111111110C00000000000C0111111111111111111
11111111111111111000111111111000111111111111111111
100000000111000000000000001110E0111111111111111111
10CCC000011100000000000000111000111111111111111111
10C1C000000000000000000000111111111111111111111111
10CCC000000000000000000000111111111111111111111111
11000000000000000000000001111111111111111111111111
11100000000000000000000011111111111111111111111111
11110000000000000000000111111111111111111111111111
11111111111111111111111111111111111111111111111111