11111111111111111111111111111111111111111111111111
11111111100111111111111111111111111110000011111111
11111111100111111111111111111111111100111001111111
11111111111111111111111111111111111001111100111111
11111111111111111111111111111111100011111110111111
1111111111111111111111111111111110C011111100011111
1111111111111111111111111111111110001111110C011111
11111111111111111111111111111111111111111100011111
11111111111111111111111000001111111111111110111111
11111111111111111111100000C01111111111111110111111
11111111111111100000001110000000111111111100011111
11111111111111101111100000011110011111111100011111
11111111111110000111111111111110000111111110111111
11111111111110CC00111111111111100C0000000000111111
11111111111110000000111111111111000111111111111111
11111111111111110000111111111111111111111111111111
11111111111111111101111111111111111111111111111111
11111111111111111101111111111000111111111111111111
111111111111111111011111111110P0111111111111111111
11111111111111111000111111111000111111111111111111
111111111111111110C00000000000C0111111111111111111
11111111111111111000111111111000111111111111111111
111111111111111111111111111110E0111111111111111111
11111111111111111111111111111000111111111111111111
11111111111111111111111111111111111111111111111111
11111111111111111111111111111111111111111111111111
11111111111111111111111111111111111111111111111111
11111111111111111111111111111111111111111111111111
11111111111111111111111111111111111111111111111111
11111111111111111111111111111111111111111111111111