11111111111111111
1C100100010000011
1E100100000010001
1P100001111111101
1010CC01010010101
11111111111111111
