11111111111111111
1C10C10C010000C11
10000100000010001
10100001111111101
1P100C010100101E1
11111111111111111
