11111111111111111
1C100100010000011
10000100000010001
10100001111111101
1P10CC010100101E1
11111111111111111
