111111111111111111111111111111111111111111111111111
100010000000000010000000000010001010000010000010001
111011101011111010101011101110111011101110111111101
1000000010100000101P1010001010001000001000000010001
101111101110101010111011111011101110111110111011101
101010001010101000101000101010001000001000001000001
111010101011101111101110101010111011111010111011101
100000100010001010000000100000000000001010100000101
101011101111101011101111101111111111101111101011101
101010000000000000100000001010101000101010101010001
101111111011111011101110111010101110101010101110111
100000001000000010000010001000100010000010001010001
10111110101010111111C111111110101110111111111011101
100010000010101010100010000000100000001000001000001
101011101010101010111011111010111110111011111011101
101010001010100010101000000010100000101010101000101
111011111010101010101110111111101111101010101110101
100000101010101010000000100010000000100000000010101
101011101010111110101110101111111010111111101011101
101010100000001000101010000010000010001E00001010001
111110111010111011111011111111101110101110111111101
100000100010100000000000001000000010100010100000001
111011101110101110111011111010111010101010111011111
100000101010001000001000000010001010101010100010001
111010101011101111111110111010101111111010101111101
100010000000100010101010100010101000001000000000001
101011101110111110101010111011111111101111101011101
101001000010100000000000000000000000000000001000101
111111111111111111111111111111111111111111111111111
