111111111111111111111111111111111111111111111111111
100011100000000010000000000010001010000010000010001
10C000001011111010101011101110111011101110111111101
1000000010100000101P1010001010001000000000000010001
101111101110101010111011111011101000111110111011101
101010001010101000101000101010001000001000001000001
111010101011101111101110001010111011111010111011101
100000100010001000H00000000000000000001010100000101
101011101111101000001001101111111111101111101011101
101010000000000000000000001010100000001010101010001
1011111110111V1011101110111010100010001010101110011
100000001000000010000010001000100101000000001000001
10111110101010111110C111111110100010001111111001001
100010000010101010100010000000100000001000001000001
101011100010101010100010011010111110111011111001001
1010100000000000E0100000000010100000101010101000001
111010C00010101010100000111111100000C01010101110001
100000000010101010000000100010000000100000000010001
101011101010111110101110100000000010111111101010001
101010100000000000000000000010000010001000001010001
111110111010111011111011111111101110101110111111101
100000100010100000000000000000000010100010100000001
111011101110101110111011111010111010101010111011111
100000101010001000001000000010001010101010100010001
111010101001101111111110111010101111111010101111101
100010000000100010101010100010101000001000000000001
101001101110111110101010111011111111101111101011101
10100100001010000000000000000G000000000000001000101
111111111111111111111111111111111111111111111111111
