1111111111111111111
1000000001000000001
1011011101011101101
1C110111010111011C1
1000000000000000001
1011010111110101101
1000010001000100001
1111011101011101111
111101000E000101111
1111010110110101111
100000010C010000001
1111010111110101111
1111010000000101111
1111010111110101111
1000000001000000001
1011011101011101101
1C0100000P0000010C1
1101010111110101011
1000010001000100001
1011111101011111101
1000000000000000001
1111111111111111111