1111111111111111111111111111111111
1PCCCCCCCCCCCCCCCCC1CCCCCCCCCCCCC1
1010110110110111001110010000011001
1000000101010111011111010111111101
1010110011100111001110010011000001
10101101010101010001CCCCCCCC111001
1CCCCCC1101100000CCCCCCCC100111001
1001110CCCCC1101101101101100110001
1010101C111C1111101101101100000001
1011011C101CCCCCCC0101000100111001
1010101C111C1111101101100110111001
1001110CCCCC1101101101100110011001
1000000000000000000000000000000001
1011111110111001101111000011100111
1011111110111011101111001111101111
10111011100100011CCCCCCC1110001111
1011111110000C0000110111CCCCCCCCC1
1011111110010011001101111101100001
1CCCCCCCCC111011101100011101110001
1011111110111011001100000001110001
10000000000000000000000000000000E1
1111111111111111111111111111111111